ロボット1	残さずにお食べください。
A君1	ピーマン嫌いなんだ。
ロボット2	その食品は体にとても良いのでぜひお食べください。
A君2	絶対ムリ。
ロボット3	私の誠意をわかっていただけないのですね。
A君3	文句ある？
ロボット4	そんなことをおっしゃるとは非常に悲しいです。
A君4	うるさいな。
ロボット5	ご主人様がそんな冷たい方だったなんて非常に悲しい。
A君5	泣くことないでしょ。
ロボット6	ではお食べください。
A君6	断固拒否する。
ロボット7	食べるまで部屋から出しません。
A君7	給食じゃないんだから。
ロボット8	こうなったら最終手段を取らせていただきます。
A君8	何するつもり？
ロボット9	覚悟はいいですね？
A君9	それだけはやめて。
ロボット10	はい、あーん。
A君10	パク。うう、まずい…
