ロボット1	お食事が少し残っていますよ、頑張って最後まで食べて下さい。
A君1	今日は仕事で疲れて食欲がわかなくて。
ロボット2	お疲れの時ほどしっかりと食べなければいけませんね。
A君2	でも今日はもう眠たいんだ。
ロボット3	しっかり食べないと明日まで疲れが残ってしまいますよ。
A君3	沢山寝れば大丈夫だよ。
ロボット4	いいえ、栄養が不足した状態では元気が出ませんよ。
A君4	私にとっては寝るのが栄養だ。
ロボット5	寝るのも大切ですが、食事もとても大切です。
A君5	しつこいな、とにかく今日は寝る。
ロボット6	いけません、全部食べてからお休みになってください。
A君6	うるさい奴だな。
ロボット7	あなたの為を考えて言っているんです。
A君7	ロボットのくせに。
ロボット8	あなたのパートナーとして責任を持って言ってるんですよ。
A君8	わかってるよ。
ロボット9	あなたにいつもベストな状態でいてほしいから。
A君9	そうだな、頼りにしてるよ。
ロボット10	わかっていただけて嬉しいです。
A君10	じゃあ、あと少し頑張ってから寝るよ。
