ロボット1	まだ食事が残ってますよ
A君1	もうお腹いっぱいだからいいや
ロボット2	昨日も残しましたよね？
A君2	そうだったかな
ロボット3	そうです、食欲が落ちてるんですか？
A君3	そういう訳でもないけど
ロボット4	じゃあ食べれるはずです
A君4	ロボットには分からないけど人にはその日の気分ってのがあるんだよ
ロボット5	確かにロボットですが、あなたの事は把握してるつもりです
A君5	食事しないロボットに理解出来ないと思うよ
ロボット6	私の事をそんな風に思ってたのですか、残念です
A君6	変な所で人間っぽく感じるんだな
ロボット7	私の事はいいので食事をお願いします
A君7	あ、覚えてたのか
ロボット8	食事が終わるまで次の仕事に移れませんから
A君8	何の仕事？
ロボット9	また話を逸らすつもりですか？
A君9	バレたか
ロボット10	いい加減にしないと、食欲不振の健康不良で病院の手配をしますよ
A君10	わかったよ　食べるよ
