ロボット1	もう食事は終わりですか？
A君1	もう食べたくないんだ。
ロボット2	でもまだ食事は残っていますよ、残さず食べましょう。
A君2	もう十分食べたと思うよ。
ロボット3	いえ、あなたは今日取るべきビタミンCとカルシウムがまだ不足しています。
A君3	そんなのわかるのかよ。
ロボット4	あなたの食事はすべて管理されています。
A君4	おまえに？
ロボット5	そうです。私が管理しています。
A君5	なんかいやだな。
ロボット6	そんなこと言わないでください。
A君6	データばかりだといやになるよ。
ロボット7	あなたが予定通り行動してくれると、私は嬉しいのですよ。
A君7	嬉しいくなるの？
ロボット8	はい、あなたの健康が私の喜びです。
A君8	僕が全部食べれば喜ぶの？
ロボット9	はい、あなたの健康はあなたの喜びにもつながりますよ。
A君9	じゃあ、君の喜びは僕の喜びということ？
ロボット10	その通りです、さあ食べましょう。
A君10	わかった、食べるよ。
