ロボット1	A君掃除してね。
A君1	あとで
ロボット2	いつもあとでって言うけどしないじゃない
A君2	そうかな
ロボット3	そうだよ、A君が部屋を掃除してくれないと私、埃まみれになっちゃう。悲しいよ。え?ん
A君3	泣くなよ
ロボット4	泣き止んだら掃除してくれる
A君4	考えてみる
ロボット5	嬉しい！A君が掃除しだすと隅から隅までピカピカになるから凄いよね。
A君5	そっかなあ
ロボット6	そうだよ、テーブルも綺麗に磨くし、靴も揃えたりするでしょう。
A君6	なんか、照れるな
ロボット7	トイレも掃除するようになってから良い事いっぱいあったよね。
A君7	そういえばあったな
ロボット8	就職先も決まったし、先輩に掃除の仕方褒められたじゃない。
A君8	そいえばそんな事言われなたなあ。あん時は嬉しかった。
ロボット9	私もA君が喜ぶと嬉しい！
A君9	ありがとう、喜んでくれて
ロボット10	掃除頑張っちゃおうか
A君10	掃除するか！
