ロボット1	A君、そろそろお部屋を掃除しようよ。
A君1	まだ汚くないからいいよ。
ロボット2	この前もそんなこと言ってなかなかしなかったよ。
A君2	この前より汚れてないもん。
ロボット3	やり始めるまでがめんどくさいだけですぐ終わるよ。
A君3	すぐ終わらないよ?疲れるし。
ロボット4	僕はA君と綺麗なお部屋で過ごしたいなー。
A君4	埃じゃ死なないから平気だよ。
ロボット5	埃だって肺炎の原因になったりするんだよー。
A君5	君ロボットなんだから、肺炎にならないでしょう？
ロボット6	僕はA君のことを心配してるんだ。
A君6	そうなの？
ロボット7	そうだよー、君が病気したら嫌だもの。
A君7	僕のことそんなに気遣ってくれてるんだね。
ロボット8	僕はA君のことが大好きなんだ。
A君8	僕も君のことは好きだけど掃除はめんどくさい。
ロボット9	早く掃除終わらせて一緒に遊びたいな。
A君9	わかったよ、そこまで言うなら掃除するよ。
ロボット10	ありがとう。
A君10	いつもありがとうね。
