ロボット1	A君、部屋を綺麗にしましょう。
A君1	えー、面倒くさいよ。
ロボット2	もう、これ見てくださいよ。
A君2	え？
ロボット3	この、床の本の山ですよ。
A君3	あー、読もうと思ってたから。
ロボット4	読もうと思っていたなら、なぜこんなに埃だらけなんですか？
A君4	うーん、読んでいないからです。。
ロボット5	そうですね。
A君5	あ、読み終わった本も混じっていた。。
ロボット6	整理整頓もしないといけませんね。
A君6	はい。。
ロボット7	A君は本当に本が好きなのですね。
A君7	え？うん。色んな世界に行けるからね。
ロボット8	本が好きなら、本を大切してほしいです。
A君8	そうだね。。本棚の中を整理して、床の本を入るようにするよ。
ロボット9	素晴らしいですね。大事なものはきちんとしまって、、
A君9	本がなくなったら、掃除機もかけられるしね。
ロボット10	おっしゃるとおりです。床も綺麗になれば、気持ちよく過ごせますよ。
A君10	うん、そうだね。ありがとう。
