ロボット1	Ａ君お部屋が汚れてはいないかい？
A君1	そんなことないよ
ロボット2	でも埃がこんなに
A君2	ちょっとじゃん
ロボット3	でもいっぱいたまってからだと大変だよ。
A君3	えー
ロボット4	僕は埃が大嫌いなんだ。だから埃だらけの部屋に居たくない！
A君4	僕は平気だよ
ロボット5	僕の体の中に埃が入ると壊れちゃってＡ君とお話しすることもできなくなっちゃう
A君5	えーそれはいやだー
ロボット6	だから掃除をしないかなー
A君6	僕一人で？いっぱい時間がかかるじゃん
ロボット7	いっぺんに全部じゃなくても少しづつでもいいじゃない
A君7	じゃあ床だけ掃除機かけるよ
ロボット8	おー、じゃあ僕は部屋の外で待ってるね
A君8	掃除機持ってきて
ロボット9	自分で持ってきなさい
A君9	手伝ってよ
ロボット10	分かった。
A君10	じゃあ始めよう！
