ロボット1	もうそろそろゲームを止めた方がいいよ。
A君1	うん、そうなんだけど。
ロボット2	随分時間がたってるよ。
A君2	今日は結構調子がいいんだ。
ロボット3	他にもすることがあるだろう。
A君3	あー、やられたー。
ロボット4	目を休ませないと視力が落ちるんだよ。
A君4	もう落ちてるかもしれない。
ロボット5	部屋も片付けた方がいいよ。
A君5	そのうち片付けるから。
ロボット6	君はなんでも先延ばしにするくせがある。
A君6	なんか、腰が痛いな。
ロボット7	長時間同じ姿勢をしてるからだ。
A君7	目を上げたら焦点が合いづらいかも。
ロボット8	至近距離で画面をすーっと見てるからだよ。
A君8	片づけも面倒なんだよな。
ロボット9	ゲームは逃避の一種でもある。
A君9	なんだか学校の先生といるみたいだ。
ロボット10	とにかくゲームはもう止めようね。
A君10	もう止めてるよ。
