ロボット1	ゲーム終了の時間でです。
A君1	そんなの勝手に決めないでよ！
ロボット2	いいえ、あなたのお母さんが時間を決めたのですよ。
A君2	ゲームを止める時間は僕が決めるよ。
ロボット3	でも宿題がまだのはずです。
A君3	宿題よりも大事なことがあるんだよ。今、いいところなんだから。
ロボット4	確かに、宿題よりも大事なことはあります。
A君4	でしょ？
ロボット5	ただし、それはゲームではないでしょう。
A君5	じゃあ、何？
ロボット6	それは、宿題をこなすことよりも、自ら進んで学ぼうとする姿勢や習慣です。
A君6	うわ。また始まった。
ロボット7	始まったとは？
A君7	うざい説教。
ロボット8	これは「うざい説教」ではありません。あなたがこれから大きくなって、一人で生きていくのに必要なことです。
A君8	うるさいな。ゲームだって、勉強になるよ。前よりもうまくプレイできてるもん。学習したんだよ。
ロボット9	…
A君9	ね？だから、後10分だけ。
ロボット10	…10分だけですよ。
A君10	ＯＫ
