ロボット1	そろそろゲームをやめたらどうかな。
A君1	いや、いまちょうどいいところなんだよね。
ロボット2	でも、ゲームは1時間でやめると約束したよね。
A君2	そうだけど、いまやめたらもったいないし。
ロボット3	約束を守ってくれないと悲しいよ。
A君3	約束を破るつもりはないけど、もうちょっとだけ。
ロボット4	いまやめないと、約束を破ったことになるよ。
A君4	うるさいなあ。
ロボット5	うるさいだって？
A君5	だってうるさいんだもん。
ロボット6	君のことを心配して言っているのにショックだよ。
A君6	ごめん。
ロボット7	ゲームにはまって勉強する時間がなくなったり、夜更かしするのはよくないよ。
A君7	確かにそうだよね。
ロボット8 	 君もわかっているんだね。
A君8	わかっているけど、ゲームをいいところで終わらせるのは難しいんだ。
ロボット9 	 ゲームは明日もまたできるよ。
A君9 	 そうだね。
ロボット10	わかってくれてうれしいよ。
A君10	うん、今日はもうやめるよ。
