ロボット1	Ａ君、そろそろゲームはおしまいにする時間だよ。
A君1	もうちょっとー。
ロボット2	お母さんにも、一日1時間までって言われてるでしょ？
A君2	だって今すぐにやめられないもん。
ロボット3	じゃあ、今やってるところが終わったらおしまいね。約束だよ。
A君3	はーい。
ロボット4	ほら、きりのいいところまで進んだからおしまいだよ。
A君4	次のところに行かなくっちゃ！
ロボット5	ダメだよ、さっき約束したでしょ？
A君5	そうだっけ？
ロボット6	約束したんだから、きちんと守ってくれないと僕悲しいよ。
A君6	･･･
ロボット7	約束を守らない人は、他の人との約束も守ってもらえないよ。
A君7	お母さんも悲しいかな？
ロボット8	そうだね、きっとお母さんもきちんと約束を守れる子になってほしいと思ってるよ。
A君8	ちゃんと約束が守れたら、お母さんも喜ぶかな？
ロボット9	もちろん！お母さんもそうだし、僕もとっても嬉しいよ！
A君9	分かった、じゃあ今日はもうゲームおしまいにする。
ロボット10	Ａ君えらい！ちゃんと約束を守ってくれてありがとう。
A君10	えへへ。
