ロボット1	A君早く寝ないと朝起きれないよ。
A君1	今、読んでいる本いいところなんだ。
ロボット2	でも明日遠足なんだろ。
A君2	もうちょっとで犯人が分かるんだから。
ロボット3	明日また読めばいいじゃないか。
A君3	でも明日になったら話の流れに乗れないじゃないか。
ロボット4	じゃ少しさかのぼったところから読めばいいじゃないか。
A君4	でも気持ちという問題が。
ロボット5	ほらもう11時過ぎたぞ。
A君5	もうちょっと。
ロボット6	とりあえず歯磨きとトイレだけ済ましたら。
A君6	今いいところなんだから。
ロボット7	明日あさ起こすのは僕なんだからね。
A君7	分かっているよ。
ロボット8	ところで明日持ってく物の支度出来ているんだろうね。
A君8	あっまだだ。
ロボット9	もう~早くしなよ。
A君9	あと１ページ。
ロボット10	あのね犯人は・・・。
A君10	やめてくれ。今寝るから。
