ロボット1	A君、寝る時間ですよ。
A君1	そうだっけ？
ロボット2	はい、もう寝た方が良いですよ。
A君2	なんで？
ロボット3	この時間に寝た方が生活のリズムが整います。
A君3	まだ、やりたいことがあるんだよなぁ。
ロボット4	生活にはリズムが必要です！
A君4	そうかなぁ、そんなにキッチリしなくてもさ。
ロボット5	キッチリした方がＡ君の体にも脳にも良い影響があるんです！
A君5	へぇ〜。
ロボット6	僕はＡ君が幸せな生活を送ることを応援しているんです！
A君6	そうだろうけどね。
ロボット7	そうです！
A君7	わかったよ、でも明日の準備がまだできてないんだ。
ロボット8	そうでしたか、私も手伝えることですか？
A君8	あ、じゃぁ、このキャリーバッグを玄関に持って行って。
ロボット9	了解です。他には？
A君9	目覚ましを６時にセットして、彼女におやすみのメールを。
ロボット10	わかりました。
A君	僕はその間に寝る準備をするよ。
ロボット	早く寝られそうですね。
A君10	うん、そうだね。
