ロボット1	もう、寝る時間ですよ。
A君1	まだ、眠くないよ。
ロボット2	早く寝ないと明日時間通り起きることができません。
A君2	だいじょうぶ、起きられるよ。
ロボット3	きちんと睡眠をとることで、次の日も元気に遊ぶことができます。
A君3	遊ばないからだいじょうぶ。
ロボット4	わたしは、A君と遊びたいです。
A君4	いやだよ。早く寝ろってうるさいな。
ロボット5	そんな意地悪なこと言わないでください。悲しくなります。
A君5	そうなの？ごめんね。でも、本当に眠くないんだ。
ロボット6	部屋を暗くして、お布団に入ったら自然と眠くなります。
A君6	それでもだめだったら？
ロボット7	一緒に羊を数えます。
A君7	数えるのめんどくさい。
ロボット8	それでは、眠りにつくまで私が、お話をしましょう。
A君8	どんなお話？それなら、お布団に入るよ。
ロボット9	早寝早起きをすると、どんなに良いことがたくさん待っているのか、というお話です。
A君9	うーん、わかったよ。
ロボット10	よかったです。わかってくれてありがとうございます。
A君10	じゃあ、寝るまでお願いね。
