ロボット1	早く寝ましょう。
A君1	まだ眠くないよ。
ロボット2	眠くなくてももう夜中です。
A君2	なんで寝ないといけないの。
ロボット3	早く寝ると、朝早く起きられます。
A君3	朝は遅くまで寝たいよ。
ロボット4	早寝早起きが体に良いのです。
A君4	どういいの？
ロボット5	老化防止です。
A君5	そんなのどうでもいいよ。
ロボット6	ストレスの解消にもつながります。
A君6	ストレスなんてないよ。
ロボット7	肥満になるのを抑制してくれます。
A君7	少しくらい太ってもいいよ。
ロボット8	どうしてそんなことを言うのですか。
A君8	だって今健康だし。
ロボット9	あなたの将来が心配なのです。
A君9	心配しなくても大丈夫だよ。
ロボット10	早寝早起きを続ければ、今の健康も続くんですよ。
A君10	そうか、それなら早く寝るよ。
