ロボット1	Ａ君、そろそろ寝る時間だよ
A君1	まだ眠たくない
ロボット2	眠たくないかもしれないけどとりあえずベッドに入ろう
A君2	嫌だ。まだゲームする
ロボット3	もう充分したよ。寝る事は君にとってとても大切な事なんだよ
A君3	嫌だよ！ゲームの方が大事だもん！今いいとこなの。邪魔しないで
ロボット4	…君の事を思ってるんだよ…
A君4	何？
ロボット5	君が明日元気に学校行けるように、君が明日友達と思いっきり遊べるように
A君5	でも…
ロボット6	君の笑顔が見たいんだ
A君6	大げさだよ
ロボット7	本当だよ しっかり寝た次の日いつもキラキラの笑顔でおはようって言ってくれるじゃない
A君7	…わかったよ
ロボット8	本当に？！ありがとう！Ａ君！！
A君8	ゲームはまた明日すりゃいいからな ベッドに行くだけな
ロボット9	うん！そうだね。偉いよＡ君！ベッドが君をすぐ夢の世界に連れて行ってくれるからね
A君9	そうかな
ロボット10	明日もとっても楽しい1日が待ってるよ さぁ目を閉じて 心の中で3つ数えたらもう夢の中だよ
A君10	おやすみ
