ロボット1	そろそろ就寝時間ですよ
A君1	どうしても寝ないと駄目？
ロボット2	何か寝れない理由があるんですか？
A君2	たまには夜更かしもいいかなと思って
ロボット3	明日が辛くなりますよ
A君3	明日は休みだし遅く起きても大丈夫でしょ
ロボット4	駄目です
A君4	なんで？
ロボット5	生活習慣が乱れる原因になります
A君5	１日くらい問題ないよ
ロボット6	その気のゆるみが問題なんです
A君6	そんな堅い事言ってると嫌われるよ
ロボット7	私の事嫌いですか？
A君7	そういう意味じゃなくてさ
ロボット8	嫌いなら嫌いとハッキリ言ってください
A君8	そんな感情的にならなくても、ロボットに言うのも変だけど
ロボット9	ロボットにも感情はあります
A君9	へえ、初めて聞いたな
ロボット10	アドバイスを受け入れてくれないとオーバーヒート状態になります
A君10	それがロボットの感情という事？
ロボット11	そうです、そろそろ限界かもしれません
A君11	わかったよ、寝るから君もクールダウンして
