ロボット1	明日も学校だし、そろそろ寝たらどうかな。
A君1	うーん、もうちょっとしたらね。
ロボット2	今何をしてるの？
A君2	マンガを読んでるんだ。
ロボット3	明日読めばいいじゃない。
A君3	だって今、良い所なんだ。
ロボット4	明日の楽しみにすればいいでしょう。
A君4	続きが気になるんだよ。
ロボット5	こんなに夜更かしして、明日遅刻したらどうするの？
A君5	大丈夫だよ。
ロボット6	どこからそんな自信がわいてくるのかなあ。
A君6	呆れないでよ。
ロボット7	だって、朝は弱いじゃないか。
A君7	まあ、そうだけど。
ロボット8	じゃあ、私の言うことを聞いてもう寝ようよ。
A君8	何だか偉そうだなあ。
ロボット9	偉そうだなんて、ひどい！
A君9	ごめん、心配してくれてるんだね。
ロボット10	そうだよ。
A君10	じゃあ寝るよ、ありがとう。
