ロボット1	Ａ君、もうこんな時間だよ、早く寝ないといけないよ
A君1	わかってるよ
ロボット2	明日は大事な試合だよ
A君2	…(無言)
ロボット3	本当に分かってるの？
A君3	だから分かってるよ
ロボット4	早く寝ないと明日、体がもたないよ！
A君4	うん
ロボット5	Ａ君のためだけじゃないよ！
A君5	…(無言）
ロボット6	Ａ君もみんなも今まであんなにつらい練習に耐えてきたんだよ！
A君6	うん
ロボット7	ベストコンディションでのぞまないと！
A君7	それはそうだけど
ロボット8	努力が無駄になってもいいの？
A君8	それは絶対に嫌だ！
ロボット9	そうだよね、これまでのみんなの努力が無駄になるのはつらいよね
A君9	うん、そうだね、明日はみんなでベストを尽くすよ！
ロボット10	よかった！頑張ってね、応援してるよ
A君10	頑張るよ、おやすみ！
