ロボット1	ほらほらこれも残さずお食べ。
A君1	俺が茄子が苦手だって知ってるだろー
ロボット2	彼女さんは全部食べてくれたよ？
A君2	なら俺の分も食べてもらおっかなー？
ロボット3	いんや、お残しは許しまへん！
A君3	じゃあ後で食べるから置いといて。
ロボット4	ふぇぇん、こんなこと言う子じゃなかったのにー
A君4	あ、このやり取り昔からだから。
ロボット5	転んだ私に絆創膏貼ってくれた子が…クスン
A君5	優しい子だったのよ？俺って。
ロボット6	オネショシーツを洗おうと頑張ってた子が…クスン
A君6	ま、まぁおふくろを気遣って…さ。
ロボット7	弟ができたからやっと5歳でおっぱいをやめた子が…クスン
A君7	兄の自覚に目覚めたっていうかー
ロボット8	彼女さんが気にするからってエロ本を…
A君8	わーーー！
ロボット9	彼女さんが気にするからってメル友の…
A君9	わーーーーーーーーーーー！！
ロボット10	彼女さんがー
A君10	なんか茄子が食べたくなってきたなー
ロボット	そうでっか？
A君	ほら、うまい！全部食うぞーーー！
