ロボット1	もう夜中だし、寝たほうがいいと思いますよ。
A君1	もう少ししたらね。
ロボット2	あと何分ですか。
A君2	さあ、何分かなあ。
ロボット3	はっきりしてください。
A君3	もう少しは、もう少しだよ。
ロボット4	あと何分か決めてくれると嬉しいのですが。
A君4	そんなロボットみたいにきっちり決められないよ。
ロボット5	どうせ私はロボットですよ。
A君5	拗ねないでよ。
ロボット6	あなたのために言っているのに、聞いてくれないからですよ。
A君6	僕の好きなようにさせてよ。
ロボット7	そんなことして、明日起きられなかったらどうするんですか。
A君7	ちゃんと起きられるから大丈夫さ。
ロボット8	私は起こしませんよ。
A君8	どうして、起こしてよ。
ロボット9	あなたが夜更かししたくてしてるんだから、睡眠の邪魔もしません。
A君9	面倒くさいことを言うなあ。
ロボット10	静かにするから、私の言うことを聞いてくれますか。
A君10	分かったよ、もう寝るよ。
