ロボット1	ねえ、もうそろそろ寝ようか？
A君1	まだ寝たくないよ
ロボット2	もう夜遅いから、明日起きれなくなるから寝ようよ？
A君2	えー!?まだ遅くないよ
ロボット3	こんな時間まで起きてたら朝起きれなくなるから、寝よう？
A君3	まだ寝たくないよ
ロボット4	なんで僕の言うこと聞いてくれないんだよ!!
A君4	なんで怒ってるの？？
ロボット5	キミが僕の言うこと聞いてくれないから、とってもかなしいんだよ
A君5	えっ!?泣いてるの!?
ロボット6	僕、キミのことが大好きなんだ
A君6	僕だって大好きだよ
ロボット7	だから、キミには、ずっと元気でいてもらいたいんだ。
A君7	僕は、どうしたらキミは喜んでくれるの？
ロボット8	夜遅くまで起きてると、健康に良くないから、もう寝よう？
A君8	そうなんだ、キミがそう言うなら。
ロボット9	わかってくれたんだね、嬉しいよ!!
A君9	良かった、笑ってくれた!
ロボット10	じゃあ、寝ようか!
A君10	うん、おやすみなさい
