ロボット1	Ａ君、そろそろ寝ようよ。
A君1	えーまだ早いよ。
ロボット2	おやすみなさい。
A君2	だから、まだ寝ないってば。
ロボット3	明日は何時に起きるの？
A君3	７時かな？
ロボット4	そう言って今日は７時半まで布団から出て来なかったでしょ！
A君4	そんなに怒らないでよ。
ロボット5	じゃ明日は７時に起きれるんだね？
A君5	う、うん。
ロボット6	本当に？
A君6	ぼくのこと疑うの？
ロボット7	先月のデータで７時に起きた日は３日だけだったからね。
A君7	そうだっけ？
ロボット8	昼間にものすごい睡魔と戦ってないか心配だよ。
A君8	昼の分も足せば睡眠不足にはならないんじゃない？
ロボット9	その時間の勉強は頭に入ってないでしょ？
A君9	あーたしかに。
ロボット10	それで昼間にＡ君の脳が最高のパフォーマンスが出せるように睡眠の計画を作ったんだよ。
A君10	やること早いな。
ロボット11	このグラフ見て、いつ寝るの？
A君11	…今でしょ？
ロボット	じゃもう一回、おやすみなさい。
A君	それでスッキリ起きれるなら試しでみるか。
