ロボット1	最近運動不足のようです。健康のために何か運動しましょうよ。
A君1	めんどくさいよ。今日は疲れたから後で。
ロボット2	適度な運動は体をすっきりさせますよ。
A君2	運動したい気分じゃない。
ロボット3	A君の健康のためですよ…
A君3	うるさいなぁ。疲れてるんだってば。
ロボット4	僕は君のことが心配なんです…。A君が病気にならないようにするのが僕の役目です。
A君4	それはわかってるけど…
ロボット5	簡単から始めてみてはどうですか？
A君5	例えば？
ロボット6	家の中でできるヨガや、ビデオ見ながらエアロビをしたりするのはどうでしょう。
A君6	エアロビのビデオなんて持ってないよ。
ロボット7	YouTubeなどの動画サイトで簡単に見つけられますよ！
A君7	じゃあちょっと検索してみるか…
ロボット8	やる気になってくれましたか？
A君8	これなら楽しく出来るかも…
ロボット9	このビデオオススメですよ！今話題のものです。
A君9	じゃあちょっと試してみるよ！
ロボット10	はいぜひ！A君が楽しく運動できるようで嬉しいです。
A君10	うん。ありがとね。
