ロボット1	運動不足が続いていますよ。このままだと体に良くないですよ！外に出てジョギングをしましょう。
A君1	私は外に出たくない。運動するのは非常に疲れる。明日の仕事にも影響が出るのでやりたくないよ。
ロボット2	今日で２週間運動をしていない、こんな状態では余計に仕事のパフォーマンスが落ちてしまいます。
A君2	うるさい。僕は運動が嫌いなんだ。放っておいてくれ。
ロボット3	なんてことですか、私がなんのために存在しているかご存知ですか？？
A君3	知らないよ。話しかけないでくれ。
ロボット4	私は生活を改善するために作られたロボットです。
A君4	だからなんですか。
ロボット5	あなたが、私の話を聞いてくれなければ私の存在意義はなんなのでしょう？
A君5	知らないよ。私が君を買ったわけではない。
ロボット6	私というロボットの存在意義を認めてもらう意味も含め何とかランニングをしてくれませんか？
A君6	しつこいな。今日は気分ではないんだ明日にしてくれないですか。
ロボット7	A君、その発言は14日間同じ発言をしています。温厚な私でも流石に我慢できません。
A君7	わかった。今日は、体調が悪い必ず明日やる。信じてください。
ロボット8	本当に信じていいのですか？
A君8	もちろん、神に誓って必ず明日運動をする。
ロボット9	わかりました。スケジュールに登録致します。
A君9	ありがとう。
ロボット10	では、明日改めてアラームします。
A君10	よろしく！
