ロボット1	A君、ゲームの時間が長くなっているから休憩しよう
A君1	後少しで倒せるから
ロボット2	もう2時間ゲームをしているので、これ以上はだめです。
A君2	何時間しても自分の買ってだろ
ロボット3	お母さんとの約束でゲームは2時間までと言われています
A君3	あと、1時間だけやらせてよ
ロボット4	やらせてあげたいけど、お母さんとの約束は体節ですよ
A君4	お母さんにはないしょでお願い
ロボット5	だめです、お母さんの約束は守るように言われているんです
A君5	なんで2時間なんだ
ロボット6	2時間以上ゲームをすると、目が疲れて視力が落ちてしまうし、姿勢が悪くなるからだよ
A君6	目と姿勢が悪くなるのか
ロボット7	そうです
A君7	休憩したら、またゲームしてもいい
ロボット8	今日は、もうゲームはやめた方がいいです
A君8	もっとゲームしたいよ
ロボット9	宿題は終わりましたか
A君9	まだ、終わっていない
ロボット10	お母さんが、もうすぐ帰って来ますよ
A君10	はーい、ゲームやめて宿題します。
