ロボット1	そろそろゲーム終了の時間です
A君1	え？もうそんな時間なの？
ロボット2	はい
A君2	もう少しやらせてよ
ロボット3	駄目です
A君3	明日はやらないから、明日の分という事で
ロボット4	そういう問題じゃなくて長時間やる事が駄目なんです
A君4	何で駄目なの？
ロボット5	最近、長時間のゲームでの健康被害の報告が増えてますから
A君5	それってそんなに深刻な事なの？
ロボット6	ゲームによる人間の脳に対する研究はまだ研究中です
A君6	じゃあゲームが体に悪いって理由にならないでしょ
ロボット7	原因は解りませんが、影響がある事は間違いありません
A君7	なんか説得力に欠けるな
ロボット8	悪影響は体だけに影響する訳ではありません
A君8	どういう事？
ロボット9	ゲームに費やした時間で他の作業の時間が少なくなります
A君9	例えば？
ロボット10	睡眠時間が少なくなると健康管理や明日の生活に悪影響が出ます
A君10	なんかゲームするだけで大げさな話になってきたな
ロボット11	分かって頂けましたか？
A君11	わかったよ、続きは明日にする
