ロボット1	ゴミ発生、ゴミ発生。
A君1	えー？
ロボット2	食べカスが床に落ちました。
A君2	ちょっとじゃん。
ロボット3	もう塵が積もって山となってます。
A君3	そんな神経質にならなくても…
ロボット4	いえ、既に１ヵ月掃除をサボっています。
A君4	まだ大丈夫だよ〜
ロボット5	部屋がゴミだらけになります。
A君5	むしろもうゴミ溜め。
ロボット6	なんと！　嘆かわしい。
A君6	悲しまないで〜
ロボット7	１ヵ月前に「屑！カス！」と言われて振られましたね。
A君7	なんで今それを…
ロボット8	あなたは屑やカスと呼ばれ、ここはゴミ溜め。
A君8	…ほじくり返さないでくれたまえ。
ロボット9	ゴミ溜めに屑カスとは…
A君9	いや、だからやめて…
ロボット10	可哀想でしょうがありません。
A君10	やるからもう言わないで。
