ロボット1	A君、部屋が散らかっているから掃除をしたほうがいいね。
A君1	まだ全然平気だよ。
ロボット2	洋服も雑誌もあちこちに置きっぱなしじゃないか。
A君2	そうかな、気にならないけど。
ロボット3	洋服はタンスに、雑誌は本棚と整理する場所が決まっているでしょ？
A君3	別にどこに置いても良いじゃない。
ロボット4	本来座るべき椅子の上や床のあちこちに置きっぱなしは良くないよ。
A君4	別にいいじゃん。
ロボット5	何日の放置していては埃も貯まるし不衛生だよ。
A君5	そんな汚くないよ。
ロボット6	埃にはダニも寄ってくるし、ハウスダストは体にもよくないよ。
A君6	気持ち悪いこと言うなよ。
ロボット7	埃やハウスダストはA君だけじゃなく、ロボットでもある僕にもよくないんだ。
A君7	お前に影響あんの？
ロボット8	僕だって精密機械なんだ、埃が原因でショートする可能性だってあるんだよ。
A君8	大げさだよ。
ロボット9	僕が壊れても良いの？
A君9	そうはいってないけど。
ロボット10	身の回りを清潔にすることは必要なんだから、掃除をキチンとしてよ。
A君10	わかったよ。
