ロボット1	運動をしませんか？
A君1	いま？
ロボット2	はい、運動をしませんか？
A君2	うーん、いまはいいや。
ロボット3	運動をすると健康になります。
A君3	わかってるよ。
ロボット4	気分転換にもなります。
A君4	わかってるよ。
ロボット5	適度な運動は、心身ともに健康になります。
A君5	わかってるってば。
ロボット6	最近運動しないあなたに私は怒っています。
A君6	なんで起こるのさ。
ロボット7	あなたが自分の健康を気にしないからです。
A君7	君に関係ないだろ。
ロボット8	あります、あなたの健康は私の幸せなのです。
A君8	なんで？
ロボット9	あなたは私の友達だからです。
A君9	友達かぁ。
ロボット10	お願いします、少しでも良いです、元気でいて欲しいのです。
A君10	わかったよ、じゃぁ、ちょっとだけするよ。
