ロボット1	最近運動不足じゃないかい？
A君1	駅まで歩いているよ。
ロボット2	駅まで歩くのは運動とは言えないよ。
A君2	結構疲れるんだけどな。
ロボット3	運動しないから体の筋肉も弱っているんだよ。
A君3	運動するところも無いんだよ。
ロボット4	ジョギングなら場所も要らないよ。
A君4	いかにも運動してますって感じでいやだな。
ロボット5	何をつべこべ言ってるんだ。
A君5	この辺にランニングコースなんて無いよ。
ロボット6	僕なら並木通りを走るよ。
A君6	あそこは景色がきれいだね。
ロボット7	かっこいい服を買ってからにするよ。
A君7	先延ばしは君の悪いクセだよ。
ロボット8	かっこいい服だと余計に運動してますって感じだね。
A君8	確かにそうだな。
ロボット9	いつもの着慣れた服装でいいから走っておいで。
A君9	着慣れた服って言われても。
ロボット10	Ｔシャツとデニムパンツでいいよ。
A君10	うん、分かった。
