ロボット1	運動しようよ。
A君1	面倒だからいや。
ロボット2	僕も一緒にサポーツするよ。
A君2	いや、サポートしてもらってもいやなものはいやだよ。
ロボット3	そうか、悲しいよ。
A君3	悲しい？
ロボット4	僕の事いやなのかな？
A君4	いや、いやなんて言っていないじゃないか。そんなこと言うと怒るぞ。運動をするのがいやなんだよ。
ロボット5	どうしたら運動する？
A君5	なんで運動させたいの？
ロボット6	君の健康を考えたのさ。ねえ、どうしたら運動する？
A君6	ありがとう。僕の事を考えてくれたんだね、嬉しよ。運動といっても大変そうだから。
ロボット7	だったら、簡単なものはどうかな？
A君7	簡単なもの？
ロボット8	ジョグングとかはどうかな？
A君8	ジョギングだったら始められるかも。
ロボット9	継続して運動することが大切だから僕が記録をつけるよ。
A君9	おっ、それは助かるよ。嬉しいよ。励みになるしね。
ロボット10	では、明日から始めよう。
A君10	うん。よろしくな！
