ロボット1	A君掃除はしないの？
A君1	まだいいよ。
ロボット2	もうこんなにたまっているよ。
A君2	指で触ってつかなきゃ大丈夫。
ロボット3	指で触ってつくって相当だよ。
A君3	何かさたまる位じゃないと掃除するのは損な気がして。
ロボット4	損とかの問題じゃないでしょ。
A君4	だってたまにしか来客来ないしさ。
ロボット5	たまに連絡無しに来る人もいるでしょ。
A君5	そのときは我慢してもらうよ。
ロボット6	自分勝手だね。
A君6	自分家なんだからいいじゃん。
ロボット7	いいけど具合い悪くなっちゃうよ。
A君7	ピンピンしているじゃん！
ロボット8	いい加減掃除しなよ。
A君8	手伝ってくれたらする！
ロボット9	自分でしなさい！
A君9	わかったよ。
ロボット10	掃除したら一休みしましょう。
A君10	うん早く終わらしちゃおー！
