ロボット1	これから外に出てジョギングをしてみないかい？
A君1	今はいいよ
ロボット2	今天気がいいんだよ、外に行ってみようよ
A君2	行きたくないな
ロボット3	外気持ちいいよ、行こうよ
A君3	いやだ、面倒くさい
ロボット4	君のためを思って言ってるんだ、行こうよ。
A君4	頼んでないし。
ロボット5	なんでそんなこと言うんだよ！
A君5	なに怒ってるんだよ
ロボット6	キミがそんな悲しいこと言うからだよ
A君6	じゃあ、どうすれば喜んでくれるの？
ロボット7	少しずつでいいから、外で運動して欲しいんだ。
A君7	外で運動すれば、喜んでくれるの？
ロボット8	うん。キミがジョギングを始めてくれたら嬉しいよ
A君8	そっか、少しずつでいいんなら、僕やってみようかな
ロボット9	ほんとにジョギングを始めてくれるの？
A君9	うん、やってみようかな。
ロボット10	そうと決まったら、これから外へ行こう！
A君10	うん!ジョギングをしよう!
