ロボット1	さぁ運動しましょう
A君1	嫌だよ
ロボット2	そんな事ではダメです
A君2	ロボットだって運動しないじゃないか
ロボット3	ロボットは運動しなくても体の発達に問題ありません
A君3	そんなのずるいよ
ロボット4	良いですか？大きくなる為にはちゃんと運動もしなくてはダメです！
A君4	良く食べて良く寝てれば大きくなるよ
ロボット5	それでは横に大きくなるだけです！
A君5	運動しんどいもん・・・
ロボット6	最初はそういうものです。やってる内に慣れてきます。
A君6	うーん、じゃあ軽いのなら・・・
ロボット7	それに、運動することによって体の代謝も良くなり汗を流すことによって老廃物を体外に排出することが出来るのですよ
A君7	何から始めれば良いの？
ロボット8	ジョギングとかどうでしょうか？
A君8	この炎天下に辛いよ
ロボット9	では、屋内で簡単なストレッチから始めましょう
A君9	わかった。それならやれるよ
ロボット10	ストレッチを３０分やったあとにランニングマシーンで走りましょう。
A君10	えぇ？！結局走るの！！
